N N N N N N N N N N N N N N N N N N N N N N N N N N N N N N N N N N N N N N N N N N N N N N N N N N N N 
N N N N B B B B N N N N B B B B N N N N B B B B N N N N B B B B N N N N B B B B N N N N B B B B N N N N 
N N N N B B B B N N N N B B B B N N N N B B B B N N N N B B B B N N N N B B B B N N N N B B B B N N N N 
N N N N B B B B N N N N B B B B N N N N B B B B Ir Ir Ir Ir B B B B N N N N B B B B N N N N B B B B N N N N 
N N N N B B B B N N N N B B B B N N N N B B N N N N N N B B N N N N N N B B B B N N N N B B B B N N N N 
N N N N B B N N N N N N B B N N N N N N N N B B N N N N N N B B N N N N B B N N N N N N B B N N N N N N 
N N B B N N N N N N B B N N B B N N N N B B N N N N N N B B N N N N N N N N B B N N B B N N N N N N B B 
Ir Ir N N N N N N B B N N B B N N N N N N N N B B N N N N N N B B N N N N B B N N B B N N N N N N Ir Ir N N 
N N N N N N B B N N N N N N B B N N N N B B B B B B B B B B B B N N N N N N B B N N N N N N B B N N N N 
N N N N B B B B N N N N B B B B N N N N B B B B N N N N B B B B N N N N B B B B N N N N B B B B N N N N 
N N N N B B B B N N N N B B B B N N N N B B N N N N N N B B N N N N N N B B B B N N N N B B B B N N N N 
N N N N B B B B N N N N B B B B N N N N N N N B N N B B N N B N N N N N B B B B N N N N B B B B N N N N 
N N N N N N N N N N N N N N N N N N N N N B N B N N N N B N B N N N N N N N N N N N N N N N N N N N N N 
